XXXXXXXX
XE____PX
X_XX_X_X
XBX_UX_X
X_X___BX
X_XXX_EX
XP_____X
XXXXXXXX